1111111111111111111111111111111111
1E0000000000000C00000C000000000001
1010010100100000101M01000000010101
1000000000000000000000000000000001
100000000000000C00000C000000000001
1010010100100000101M01000000010101
1010010010101010001001000000010101
100000000C00C00000000000M00C0000C1
1000000000000000000000000000000001
101001010010M000101001000000010101
1000000000000000000000000000000001
100000000000000C00000C000000000001
101001010010M000101001000000010101
1010010010101010001001000000010101
100000000C00C00000000000000C0000C1
1000000000000000000000000000000001
1P0000000C00C0000M000000M00C0000C1
1111111111111111111111111111111111
