1111111111111111111
10000000001M0000001
1000000100001000001
10001000000C0001001
1000100001000000001
10C0001001000001001
100M0C0001000C00001
10000000C0000001001
1000101000000000001
1P0010000000C000001
10001001M00000000E1
1111111111111111111
