1111111111111
1001000M000C1
1000011111001
1P0E110000001
1111111111111
