111111111111111111111111
10010000000C0000000000C1
1000011111000010000000C1
1P0011E000000010000000C1
10010000000C0010000000C1
111111111111111111111111
