111111111111111111111111111
100000000E00000000000000001
101001010010001010010000001
101001001010100010010000P01
111111111111111111111111111
